1111111111111111111
10000001C1100P00001
11000C00E0000000001
1000000000001000001
1111111111111111111