1111111111111111111
1C00E000001C00P0001
1000000000000000001
1000000000000000001
1111111111111111111